##.##
#...#
#.#.#
#...#
#...#
#.###
\robot 1 4
\robot 1 3
\robot 2 2 
